#####B##### ##       #
##### ##### ######## #
####                 #
#### ## ### ######## #
     ## ### ##       #
A########## ##########
 ##         #        #
 ## ####### ######## #
 ########## ######## #
                     #
######################