                    ######     #
 ########### #######    ###### #
###                # ###       #
################## # ######### #
                   #           #
########## ####### # ######### #
 ##                #      #### #
 ## ### ## ###### ## ######### #
    #   ## #                   #
 ## ################ ######### #
 ##             #### #B      # #
 ############## ## # ## ###### #
             ##    # ## #      #
### ######## ####### ## # ######
### ####              #        #
A   ############################
